                                                        F 150,70,50

NO assets/mario2.xpm
EA assets/mario1.xpm
SO assets/mario2.xpm
WE assets/mario4.xpm
       C          65,105,225






1111111111
   11C0001
 110000011
1000001111
100000111
10000111
1000011
1000N11
1111111
1111111
