NO assets/mario2.xpm
EA assets/mario1.xpm
SO assets/mario2.xpm
WE assets/mario4.xpm
       C        100,30,0
F 220,10,5

11111
110101
100001
100001
100001
100N01
111111