NO assets/simonkraft/respawn_anchor_side0.xpm
EA assets/simonkraft/respawn_anchor_side2.xpm
SO assets/simonkraft/respawn_anchor_side4.xpm
WE assets/simonkraft/respawn_anchor_side3.xpm
       C        100,30,20
F 220,10,5

11111111
10100101
10000001
10000001
10000001
10000001
100000N1
11111111
