NO assets/mario2.xpm
EA assets/mario1.xpm
SO assets/mario2.xpm
WE assets/mario4.xpm

C 50,50,205
       
F 50,250,25


        1111111111111111111111111
        1000000000110000000000001
        1011000001110000C00000001
        100100C00D0000000000C0001
111111111011000001110000000000001
10000000000D00000111D11111D111111
1111011111111111100000010001
11110111111111011101010010C01
11000000110101011100000010001
100000C00000000011000C0010C01
100000000000C0001101010010001
11000001110101011111011110N1111
11110111 1110101 1011110D0001
11111111 1111111 11111111111
