NO assets/mario2.xpm
EA assets/mario1.xpm
SO assets/mario2.xpm
WE assets/mario4.xpm

C 50,50,205
       
F 50,205,50


        1111111111111111111111111
        1000000000110000000000001
        1011000001110000000000001
        1001000000000000000000001
111111111011000001110000000000001
10000000001100000111011111D111111
11110111111111011100000010001
11110111111111011101010010001
11000000110101011100000010C01
10000000000000001100000010001
10000000000000001101010010001
11000001110101011111011110N1111
11110111 1110101 1011110D00D1
11111111 1111111 11111111111
