NO assets/mario2.xpm
EA assets/mario1.xpm
SO assets/mario2.xpm
WE assets/mario4.xpm
       C        100,30,0
F 220,10,5

11111111
 0100101
10000001
10000001
10000001
10000001
100000N1
11111111
