11111111
10100101
10100201
10100001
10001001
10000101
10000001
11111111
