11111111
10100101
10100001
10100001
10001001
10000001
10000001
11111111
