11111111
10100101
10100001
10100001
10001001
10000101
100000N1
11111111
