11111111
1010S101
10100001
10100001
10001001
10000101
10000001
10000001
11111111
