NO ./textures/north.xpm


SO                   ./textures/south.xpm
				WE ./textures/west.xpm

C 0,0,255

EA ./textures/east.xpm


F 0,255,0
111111111111111111111
101000001000000000001
101010101011111110N01
100010100010000010001
111110101111101011101
100000101000101000001
101111101011101111111
101000001010100000101
101011111010111110101
101010000000100010101
101110000000101010101
100000000000001010001
111111101011111011101
100000111011110010001
101110000000001110111
101000000000000010101
101000000000000010101
101000000000000010001
101000000000000001101
101000001000000000001
111111111111111111111
1
